*-*--**--****-*-*--*----*-*-----*---*-*-------*--*-------**----*--**-**-***---**---***---**--**-***-
-**-----*-***--*--*********---*--*-**--*-*------*--*-*--*----***-*--*--**--*****-**-*-**-*--*----*--
----****-*--------**---*-*--*--*-*--**---*-*----*---*----*---**--*-*--**-*****-**-*---*-*----*-*--*-
-------**-******--*----***-**--*----**-**---*--*---*-*--*-*---**--**---------*--*----*-**-*--*-**---
****----****-*--*****---*-*---***-*-*----**-*-*--**---**-*--*-**---**--*----*-*----***----**---*---*
--*----**-*----**----**--***---*--**----**------*****-*----*-******--*-**---*-*-**-*--*-**-*-*-*--*-
*-*--**-*-*****-**-*---***-**-*------***-**--***-*-***------**--**---*-*-****---*-*-**---**--*--**-*
-*-**-*----**----**-***-*-------**---**-----------**-*-*-*-*-*--*-*--*--*-------*----****--**--*---*
****-*-*--*--*-----*--*--*---***---**---*-***--**--*--*-**-*-------*-*-*-*--*---*-***---*-*****-**--
-*--*---*----***--------**--***----*-*-*--*-**-*-**-**-**----*****-***--*-***-------------*-----*---
*--****-*-**----*--*---*--**---**---****-*-----*----*----**----*-*---*--**-*----**-**-*-**--**-**---
------------***----*----*-**---*---**-*---*--*-------*--**----*---*---*-*-**------***-**---**-*-*---
-----****--*--***---*-****-**--*-*--*---*--*-------*--*-**-----*-*---****---**----*-*-*-***---***--*
--*----*--*----*---**--*--*--**-------*---**-*-**-***----*-**--**---*-*-----*-------*-*-**---*-**---
*--*-*-*-**-**--**-----**-*-----***-*-----**-*----*--**----**-*----**-----*-*-*-----***----******-**
*-*---*--*-*-*-*-*-*---*-*----------*----**------**-**--**--*------***----**-***-*-*---*-*-*****---*
----***---**---*-*---**-**-----***----*----*-**-*-**--*-*---*-*-*--***--*-*-**--**---*--*-*--*------
*-*----**--**-----****-*---*-----------*-*-*-------*-*-**-*-------*-*-***-******---*---*-*--**---**-
*-**--*-**---*----*--*-**-*-*--*----****-**-**--***-*---*--*----**-----****--***-------*-*-*----**--
*--*-*--*--------*-******-**--**-*-*----*---**----**------*---------**--*-***-*---*--*--**------****
-*--*---*--*-***-*--*---****---*---*****---*-*----*-*-*--*--***---*-**----**--*--*-**-***-**--*-***-
---------*-*-----****-*--------*--**--*--*---*-****----*----**-*--*---*--*----*-**----***-*---**-**-
--***-*-**-***--*---*-------*--*--*-*-*---*-*-**---*-----*-*-*-----**-****----*-*-**-*--*-------**--
***-*---*--*--**---*--*--*--**-*------*----**-*--***-**--*----*-*----**-*-**---*-**--*------*-*---*-
**-**--*-*--***--**-**-*-*-*---**-*---*-**-*--***--*--*---*---------------****--*-**-*---*--**-*-*-*
--***--****-------*-*--------*-***--*----*----------*---*-***--***-*-*****----*-*---*---***--**-*--*
-*-**-**---------*-*-*-------*-*-*--***-*--*-*-*-***-*--********-*-------****--*-*---**---***---*-*-
--*------*--*-*----**-***-*----*-*-*---**----***-**--*---*--****---*----***-****---**--*--**----*---
**-*-**-**-*----*---*----***--*-*---*-****--****-**--*-*--------*--*-******--*-*-*---**--**-**-*-*--
*----**-**-*----***-----**-*--*--**----**-****----*--**-**----*-----*---*---*-*---**--**-**-----*---
----*-----*--**---***--****-*-----*----*-----****---*****--**-*-*-*****-**---*-**--*--**----*-*---**
-*------*----*--*****--------*---------*-*---*-****---*---*-*--**--**--**-*--**--**-*--*----------*-
-**-**---*--**----***--*-**-*-*---**-*-*-****-*--***---*--*------**---*-----****---**-*-*--****--**-
-*--*-----*-**---**--*-*------*-**-----*---*--*---*--*------**-*****---*--**--**-*--*---**----*----*
--*-*---*---**---****-**----*--------*---*------*--*-*--------*-----*--*--**---**-**-*----***--*----
***---*-----*-------------*-**-*----*-*-------*-*-***-*-*--**-*--*--*-----**--*-**--**-**----*-*--*-
-***--*--*-*-**--**-----*-***-**----*-*-*--------*---**------*-**-*-*--***--***---**--*-----------**
-*****-*****-*-**-****-**-**----**-**--*-*---*-*-**--*-*--*-*----*-*--***-**-*****-*-*----*-----*---
-------*--*----*--*-*--**-*----*--*-*-----***---*---**--*----**-*--*-*---*-**----**-**--*--*--*-*---
*----------**--*-*****--***--*-*-*--*-*****--*-*------***----*--*---****---**--**----*--*-***-*-----
-*-*---**-***-****----***-----*-*---*--***--*-*----*--*-***-*--***-***---*-*------*--**-*--***-*--*-
---**--****-*---**----*---*----*--*--*-*--*-**--**---*--***---*----*--*-**---------*------*----*----
-*-*-*****---*--*-*---*-*-**------**--*****-*-*-**--*--*--*---*-*--*--*-*-----*--*******---*-******-
-***---*------*---***-------*--**-***--*-*----***---*---*-**-*---*---*-*-*--***-*----*-**----***-**-
-*--*--**------*****---*--*--**----*--*--*---*-*-*--**-*****----*--*-*-*-*---*----***------*--*-*---
---*-***--*-**--**--*----**----*-*---------*-----*----**-*-----*-*-*------*----**-**--**----*-*-*--*
**-***---****---**---**-**--*----*---*----*-*--*----*--*--**--*--*-*--*-----*-*------**----*-**-*--*
---*-**-**-****--*--***-*--**--**-*-*--**-*-*-*--***-*---**-*---**-*---------**---*--*-------**-*--*
***-*-***-*----**-****--------*-*--*-**----*--*---*--***----****----***--------***-*----****--****-*
--------------*-*--***-***-*---***--*--**-*--------*---**--*--*--*--**-*--*---*----**--*----***-*-*-
