-------**--*----*-------*-----------------------**---------------*--------*-----*--------------*----
-*-----**------*----***----*----------*-*--------------*------*-----------*----*---------*----------
------*-----------**-*-***--------*--**---*----*---*--*--*---*--**----**------**------*--------*----
---*-**---*------**---***-----------**-*---**--------*----*-----***------*-----*--*-----------*----*
-------*-----*---*----*-----*--*---***--------*---*---*------**-----**-*-*------------*---**-------*
---*---------**-----------------------*--*----**-*----*-----------**---------*--*--*-----*-*--*-----
--------------*-----------*---*---------**--*--------*--***-----*--------*-*-*--**-------*----*--*--
---------*-*------*--*---*----*----*--*------*------*-*-*--*--*------*----------***--------*---*----
------*-------*-*------*---------*------------**----*-***-----*----*-*----*------*--*--*-------*----
**---*--*--*-----*-**---**-*-------*--**--*--*------------------*-**-------------*---*-*------*-----
--*-*----*----*---------------*--------*-*------**--*---*---*-------------------*--**--*---****----*
---*------------*--*----------*--*----------*-*-----------*--------*----*--*-*-------**-------------
**------*-----*----***----------*-**-*--*----**---*--------*---**--*----*-*-----*----*-*---*--------
**-*--*----*---------*---------***---*-**---*-*-**----*----------*-------*-**------------*--*--*----
-----*-**--***----*---*-------*--------*---------*-----*-*-*-*-------------***---*----*--*---*--*-*-
--*-----****-***----------------------**--**--*-----*----*-*---**-*----**-*--*----*-*-*-*----*---*--
--**--------**---*--**-----*-----*---*-*--*-------*-*--------*-*----*----*-*-*----*---*-----***----*
----*----*---------------*-----**---*-----*-----------***---------*-*-*-*-*-------*----*-*-*-*------
*--------**---------------*----*-*-------**-*-**-----*-----**-----------****-----**---*--*----------
--*--***-----------*----***--*---------------*-*--*---*---*----------**--*----*----*-*----**--*----*
---*----*-----*--*-*-----------**--*------*-------*-----------*-----**-*---*--*-----*-*------------*
-------*------*----------*---*-------*-----*-*-----*--*-----*--**-*----------*---------------------*
-*-*-**----*-**----**-**----*-----*-------**-**--*---*-*-*---*-----------*-*-**-****------*---*-*---
-**-----------*------*-*-----*----*-----*--------------***------**----**------*----*-----*--*-------
------**--*---***-----****--*-----------**--*---------*-*-------------*-*----------*------*-**-----*
*----*---*---*--*--------------*--*-**-**-------*-*-----*----*--*-*----*---**-----*-----*-*---------
-*--*---*---**--------*----------*----*------**---**-----*--*-*--*---*-------------*--**--*---**--*-
-**---*--*-----------*-*-----*---------*----***--------------*----------**-------*----**-*---------*
**--*-**------*---*------------*---*------***-----**--*------*--*-------**--*-*-*-**--*---*----*-*--
---*--*---*-----------*------*-------*----------*----*---**-*---------*-----------------*-----*-----
--*-*----*------------*-*---------*--*----**------*----*-----**--*-------------------*--*----*-*----
-**-----*-----*---*--**-----*-------------**-*---***---------*-**----*---------------*-*--*-*--*---*
*-*----*--*---------------------**-------**---*-*----**--*------*------------------------*----*-----
--*-*-***-*-***----------*-------*-----------*-*-----*---*--*-------------*---------**---------*----
---*-*-------*---*----*------*-*-----*-----------------------*-------**---------*--*-*-**--*---*----
--*------*-------*-**------------*------*-------------*---*---*------***-------*---------*---**-*--*
---*-**---*----------**----*---**---*--------------**-----*---**------*--------**---*-----*--*----*-
*----*-----*-*------*-----*---------------**---**-*------------*----**-*-*--*----*--------*-----*--*
-*----*---*--*--*-*-----**-------*--*-----*------*-*-**-----**------*--*-*---------**----*------*---
----**-*----*---*-***----------*-*--*-------*---------*--**-*------*----*-------*------*----------*-
*--*------------*-----*----**-*--*-----*-**------*-------------*---*--*------*------*--------**-----
-------*-***-***--------------**-*--**---**-------*--*-**-*----*----------**---------*------*---*---
-----------------*-*----------------**--*-------*-----------**-*--*--*-----*-**---*----*------------
---------***-*-----*--***-*---*------***---------*---*---**-**---**------*--*-----------**----------
-----------*-----------*--****-----*-------*--------------*-------*--*---*---*----*---***---------*-
------**--***---*--------**--*---*---*----*------*---*--**--------*---**-----*------------**------*-
----**-*--------------------*------*--*------**-***---*---*--*----*--------*-----***-*---------*--*-
*-*------------*---*----------*--*-*-*--*-------*-----*-------------**-*-----------***--------------
-------*---*-*------*-----*-*-*--**----**-----*--*--------*--**-*----*----*--*--------------*-**--*-
---*----------*----------------------------*----------------*--*------*--**-----------**-----*------
--*---***---***--*----------**--*--*-*--*---*----------------*----*----**--**------*----------------
----------*------*------*---*------------------------*---------*---*------------*------*-*-----*----
--------*----*------*----*--------------------*-------------*----*---*---**----*-*--------*-*-*--*--
------***--*--*-------------**-*----*----------*--*-*--------*-----------*----------------**----**--
-*---*--**-----*-*-----------*-**------*---*--------------*---**-----****------------*-------*----*-
-*--**-*------*---*---------------*-*-------*--*--*-----*--*--------------------*--*------*-*--**--*
*--*--------*----------*-*-*---------**-------*-**------*---*---*--*--**-*---*-----***----*----**-*-
*----*---**---**-*-----*---*---------*--*------*-*-*----*-*--*-------------*----**------*--------*--
**--------*-------**-*------*-------**--------*-*----**-----------*--*-*----*---*------*----*-------
*--*-----------------*---------------**------*---------------*----*---------------*--*-*-*----------
*-------*--------------*-*-*-------------***-----*--**--------*---------------*-------------*-**----
-------*-*-*-*--*------------------*------*------*----**-------------*------------*-----*---*-*-*--*
-----*--**-----**-*--*-----------------------*----*--*-------------*--*--****---*-----------*--*---*
---------***--*-*---------*--**-*--*-----*------*-----*----------*--**------*-*-*----*---*-----*-*--
-----------*-*-*-----*---*------------*-----*-*------*---*----*--***-*--------------*--*---*--*-----
-----*-----**---------------*--*---*-----*-*---------**----*-------*--------*---------*-*-----*--*--
--*---*----*-----*-------**------------------***--*---------------*------*--------*-------*---------
*-*------------------*---**-------*---*--*---------*--****---**--------*-------*----------------*---
---------------*-------*--*------*-*-----*---*--------*---*----------*----*----*--*-----*-----**--*-
------*-----*-*-------------*-*---*------*------*------------------*-----*-*-----*--*--------*----**
------*----------*-*----*--*-------*------------*-------------*-------**---*-----*---*-*-*-----*----
*--*------*--*-----*-------*---*----------*-*-------------*--*-----------**--*------**----------**-*
-------**--**-------*---------*-----*-----*--------------*-*---*-*----*-----*--------*---------*-*--
------*------*-*--*---*-**-*------*-*----*----------------*----------------*---------*---*-*---*--**
*---**------*---*---*--*-----*-------***------*------**---------*-------**-----*--------*--**---*---
-----*----**-----*----*------------*------*--*-----------*------*-------------------**-----*--*-----
-----*------**------*-----------*---*---------**----*-*--------*----*---*------*----*--*----**-*----
-*--------*--*---*--*---*--------------*--*---*------*----*------*----*-----*-----*-**-**------*--*-
-----**-----*---------------*---*****------*-*--*--*-*---*----------*---*-----*-*--*------*--*-----*
---*--*--------*---------*---*---*--*--*---***---------**---**----*-------*-*---*-------**-------*-*
-----**-----*--*--------------**-------------*--------*-*--------*-*-*-*-------------*------*------*
--------**-*-------------------*------***---------*---*-*------------*-*--*--------------**-----*--*
*----*--------*--*------*---*-*----*----***------*--*---*----------*----***------*-*--------*---*-*-
-*-*-**--------------------*----*--------------*---*-*-*-----------*-----*--*---*----*--------**---*
---*-*----*---*------*--***------------***-*--*-----------------------*--**----------*-*------------
**------**--*-------**--*--------*---****--**---------*------*-----*-----**-*-*-*--*--------*------*
----**-**--------*-------------------------*-**------*---------------------------***----*-----**----
----------*-----------*--*--------*---------*-*--*------*---***--*---*---*---*-*--------*-----*-----
---*-------------*--------*--*------------------*--*----*----**---*-----*-*------***------*---*-----
------*-*----------*----*-*-----*--------------*--*---*---------*---------------------*--------*----
---------***---*-**----**----*-------------*--*------**------*------*---*-*---*------**---*---------
--*-----*------------**-------*---------**-*-----*--------*-----*---*----------------*-----**-------
--------*--------*---*--------------------*--**--*--*-*----*-*-*------*------------------*--***--*--
-*---**--------*--*****-*-------*--*----*---**-*----*----------*---*-------*-*------*--*----**------
*------------*-----**----------*------*--*---*-----*----*---*--*-------*-*----**--------*--*-----*--
--*-*------------******--**---**----*--*---*-------------*-------*---**---------------*----*----**--
-*---**----*--*----*--------*-**----*------*--*-----*--------*----------*--*-----*----*------------*
*------*-*------------------*----------------*---*---**------*----*--*-----*---*----*-------*-----*-
-------**----*--**---------------**-*--*-*---*-----------***--*-*--*---*----*--*--*----**--**---***-
--**---*-*-----------*---------**----*-----***---*--*--*---**-------------*------------------------*
---*---**---*--*----------*-------*-**---*---*--**--*--**---*-----*-**--------*-*--**---------*--*--
---------***-*-----*--*--------*----------**-*---------*---*-*----------*-*------*---*---*-----*--*-
-*----------*-----*------*-------*------***-------*-*----------------*--*--*--*------*---*-*--------
--**--*-*--*--*---*----*------*-*--***------------**-**----*--*---*--------*----*---------------*---
-*------*-*-------**--*-------**-*-*----*--*--------*--*-*--*----------*------*-*--*----*-----------
--*------*---*----*--*-------------*-------------------------*----*-----*---*--*-------*-------*-*--
*------------*---**-*--*----*------*-----------*----*-----**-****--*-----*--*---*--*------*-------*-
-*--*-------*-*--*-----------------**--*-----*-*------*------**----*-**-*-*-----------*---***--*----
*---*-*--*--*-*-----------*----*--------*---*-*-*-----------*--------*----**----**-*---**---*---*--*
*-*-------*---*--*-------*--*--*---*-------------*---------*-------------**---*----***-------------*
------*--*-*-----**----------*------*--*--*---------**---*---------------------*----*-*-*-**--------
---**---------*-*-----------*---*------*-**---*--*----*----**--*-------*-**-**-------*----------***-
*-----------*-------*-*--*--*-------*------------*-----*-----*------*------*----------------------**
*-----*-*----*--*--*-*-*---*------*---*-*--*-**----***-----*----*-*--***-*-*-*---------------*-*-*--
-------**--------**----**-----*-*--*-*--**----*-----------*---**-**------**--*---*-----*-*-*-----**-
---*-------------***--**--*--*-*-----------*--------*---**--*-*--*--*--------------*---*----*-------
-**-*--------**--*-----------*---------*--****-------*-----***------------*-----*--------*----*-----
----*-*---***-**---**-*---**---------**-----*-**-**-*--------*-----*-*--*--------------------------*
--*----------------*--------**-----*--*-----*--**-------------*----*---*-----*----*----------*----*-
--------**----*---------**--------------*-----*---------*---*-----------------------*-*----*----*--*
